######
#    ######
# $ $#  ..#
# $ $   ..#
# $ $#  ..#
#  @ ######
######
