##########
# . . .  #
#  $ $ $ #
# $@$ $  #
#. . .   #
##########
