#######
# .   #
#  $ .#
# $@$ #
#. $  #
#   . #
#######
