######
# @  #
# @  #
## . #
 #   #
 #####
