#######
#...  #
# $$$ #
#  @  #
# $$$ #
#  ...#
#######
