#######
# . . #
# $$$ #
#. @ .#
# $$$ #
# . . #
#######
